F 255,255,255

C 225,30,0

  NO   ./assets/walls/south_wall.xpm

EA 	./assets/walls/east_wall.xpm
SO ./assets/walls/north_wall.xpm












WE 					    ./assets/walls/west_wall.xpm


        1111111111111111111111111
        1000000000110000000000001
        1011000001110000000000001
        1001000000000000000000001
111111111011000001110000000000001
1E00000000BB000001110111111111111
11110MT1111111011100000010001
11110MTT111111011101010010001
11000000110101011100000010001
10000V0000000000D000000010001
1000000000000BB11101010010001
11000001110B0BB111110111100011
1111M111 1B10111 101111010001
11111111 1111111 111111111111
